I100100000
0001000001
0000010001
0000000001
000X000000
0001100000
0001000100
0000010010
0000000000
0000000000
