I110100000
0001000000
0000000001
0000000000
010X000001
0010000000
0000100000
1000010010
0100000000
0000000000
